-1  -1  -1  -1  -1  -1  -1  -1 -1  -1 -1  -1 -1  -1 -1  -1 -1  -1 -1  -1 -1  -1 -1  -1 -1  -1 -1  -1 -1  -1
-1  -1  -1  -1  -1  -1  -1  -1 -1  -1 -1  -1 -1  -1 -1  -1 -1  -1 -1  -1 -1  -1 -1  -1 -1  -1 -1  -1 -1  -1
-1  -1  -1  -1  -1  -1  -1  -1 -1  -1 -1  -1 -1  -1 -1  -1 -1  -1 -1  -1 -1  -1 -1  -1 -1  -1 -1  -1 -1  -1
2  2  2  2  2  2  2  2 2 2 2 2 2 2 2 2 2 2 2 2 2 2 2 2 2 2 2 2 2 2
2  6  3  3  3  3  7  3 3 3 3 3 3 3 3 3 3 3 3 3 3 3 3 7 3 3 3 3 3 2
2  5  1  1  1  1  8  1 1 1 10 1 1 1 1 1 1 1 1 10 1 1 1 8 1 1 1 1 1 2
2  0  0  16 16 0 0 15 0 0 9 0 0 0 16 0 0 0 0 9 0 16 0 0 0 0 16 0 14 2
2  0  0  2  2 16 16 0 0 0 0 0 16 16 2 0 0 0 0 0 0 0 2 0 0 0 2 16 17 2
2  2  2  2  2  2  2 2 2 2 2 2 2 2 2 2 2 2 2 2 2 2 2 2 2 2 2 0 0 2
2  5  1  1  1  1  2 5 1 1 1 1 1 1 2 5 1 1 1 1 1 1 1 1 1 1 2 0 0 2
2  13  14  0  0  0  2 0 0 0 16 0 0 0 11 16 0 0 13 0 0 0 14 0 16 0 11 0 0 2
2  16  0  0  14  0  11 0 14 0 13 0 0 0 4 0 16 0 14 0 4 0 17 0 4 0 0 0 0 2
2  0  0  0  0  0  0 0 16 0 0 0 0 0 0 0 16 0 16 0 16 0 0 0 0 0 14 0 0 2
2  0  0  0  0  0  0 0 0 0 0 0 0 0 0 0 0 0 0 0 0 16 0 0 0 0 15 16 14 2
2  0  0  2  0  0  0 0 2 0 0 0 0 0 0 17 0 0 0 0 17 0 2 0 16 16 16 17 13 2
2  0  16  2  2  2  2 2 2 2 2 2 2 2 2 2 2 2 2 2 2 2 2 2 2 2 2 2 2 2
2  4  0  12  1  1  1 1 2 5 1 1 1 1 1 1 1 1 1 1 1 1 2 5 1 1 1 1 1 2
2  0  0  0  0  0  0 0 11 0 0 0 0 0 16 0 0 0 0 0 0 0 11 0 0 0 0 0 16 25
2  0  0  0  0  0  0 0 0 16 0 0 0 0 0 2 0 0 0 0 0 0 0 0 0 0 0 16 0 25
2  2  2  2  2  2  2 2 2 2 2 2 2 2 2 2 2 2 2 2 2 2 2 2 2 2 2 2 2 2