-1  -1  -1  -1  -1  -1  -1  -1 -1  -1 -1  -1 -1  -1 -1  -1 -1  -1 -1  -1 -1  -1 -1  -1 -1  -1 -1  -1 -1  -1
-1  -1  -1  -1  -1  -1  -1  -1 -1  -1 -1  -1 -1  -1 -1  -1 -1  -1 -1  -1 -1  -1 -1  -1 -1  -1 -1  -1 -1  -1
-1  -1  -1  -1  -1  -1  -1  -1 -1  -1 -1  -1 -1  -1 -1  -1 -1  -1 -1  -1 -1  -1 -1  -1 -1  -1 -1  -1 -1  -1
2  2  2  2  2  2  2  2 2 2 2 2 2 2 2 2 2 2 2 2 2 2 2 2 2 2 2 2 2 2
2  6  3  3  3 3  7  3 3 3 3 3 3 3 28 29  3 3 3 3 3 3 3 7 3 3 3 3 3 2
2  5  1  2  2  1  8  1 1 1 1 1 1 1 26 27  1 1 1 1 1 1 1 8 1 2 2 1 1 2
2  0  0  2  2  0  0  0 0 0 0 0 0 0 0 0 0 0 0 0 0 0 0 0 0 2 2 0 17 2
2  0  0  2  2 0  0  0 0 0 0 0 0 0 0 0 0 0 0 0 0 0 0 0 0 2 2 0 0 2
2  0  0  2  2  0  0  0 0 0 0 0 0 0 0 0 0 0 0 0 0 0 0 0 0 2 2 0 0 2
2  0  0  2  2  0  0  0 0 0 0 0 0 0 0 0 0 0 0 0 0 0 0 0 0 2 2 0 0 2
2  0  0  2  2  0  0  0 0 0 0 0 0 0 0 0 0 0 0 0 0 0 0 0 0 2 2 0 0 2
2  0  0  2  2  0  0  0 0 0 0 0 0 0 0 0 0 0 0 0 0 0 0 0 14 2 2 0 0 2
2  0  0  2  2  14  0  0 0 0 0 0 0 0 0 0 0 0 0 0 0 0 16 0 16 2 2 0 0 2
2  0  16  2  2  0  0  0 0 0 0 0 0 0 0 0 0 0 0 0 0 0 0 0 0 2 2 0 0 2
2  0  0  2  2  0  0  0 0 15 0 0 0 0 0 0 0 0 0 0 15 0 0 0 0 2 2 0 0 2
2 16  0  2  2  4  4  0 0 0 0 0 0 0 0 0 0 0 0 0 0 0 0 4 4 2 2 0 0 2
2  0  0  11  11  14  0  0 0 0 0 0 0 0 0 0 0 0 0 0 0 0 0 0 14 11 11 0 0 2
2  0  0  16  0  0  0  0 0 0 0 0 0 0 0 0 0 0 0 0 0 0 0 0 0 0 0 0 0 2
2  14  0  0  16  0  0  0 0 0 0 0 0 0 0 0 0 0 0 0 0 0 0 0 0 0 0 0 14 2
2  2  2  2  2  2  2 2 2 2 2 2 2 2 2 2 2 2 2 2 2 2 2 2 2 2 2 2 2 2